000000100000000
000003030000000
000003030000000
000003032000000
003220000222400
032000000000400
030000000000400
030000000000400
021111111111200
000000000000000
