00518911;11<400
003=00000000300
00300000000:300
002111116711200
000000000000000
000564000054000
000303000132400
000303700030300
000303000830319
000303000030300
%7%2%