5>1;1115111;1>3
3<0000=3=0000<3
300000030000003
300000030000003
300000030000003
598007151700893
300000030000003
300000030000003
3:00000300000:3
211116121611112
%4%3%
