00005;400000000
000030211400000
00003000=300000
000030511200000
000030300000000
000030300000>00
000030218911<40
000030000000030
000030000000:30
000011611117110
%8%8%