51111;111111114
3000000000000=2
300000000000000
3:0000000000000
326714011001189
300002000000000
30000000>510004
30000000<200002
200000000000000
000000000000000
%7%5%
