5;58985111111>4
303000300000=<3
303000300000003
302000300000003
300000300000003
300000300000003
301140270000003
300:30000111123
300030000000003
211121111111162
%1%1%
