000589111;11400
000300000000300
005267000000300
00300000000>300
00240000000<240
000398900000:30
000300000000030
000211400000=30
000000211111120
000000000000000
%4%1%