589841117111100
300030000000000
300030511811400
300030200000200
300=30000000000
30012110111;1>4
300000000000:<3
300000000000003
300000000000003
286111111111112
%13%7%
