5951851;1;15>24
302003000003<:3
300003000002003
300003000000003
300002722221003
300000000000003
300222222225223
300000000006003
3000000000000=3
211111111111112
%8%1%
